11111111111111111111111111111111111111111111111111111111111111111111111111111111111111111111111111111111
11111111111111111111110000000011100000000000000000000000000111111111111111111000000000000000000000000000
11111111111111111111110000000000000000000000000000000000000001111111111111100000000000000000000000000000
11111111111111111111110000000000000000000000000000000000000001111111111111100000000000000000000000000000
11111111111111111111110000000000000000000000000000000000000001111111111111100000000000000000000000000000
11111111111111111111110000000000000000000000000000000000000000000000000000000000000000000000000000000000
11111111111111111111110000000000000000000000000000000000000000000000000000000000000000000000000000000000
11111111111111111111110000000000000000000000000000000000000000000000000000000000000000000000000000000000
1111111111111111111111000000000000000000000000000000000000000000000000000000000000000000000080000000000000000000000000
1111111111111111111111000000000000000000000000000000000000000000000000000000000000000000111111111111111100000111111111
1111111111111111111111000000000000000000000000000000000000000000000000000000000000000000000000000000000000000000000000
1111111111111111111111000000000000000000111110000000000000000000000000000000000000000000000000000000000000000000000000
1111111111111111111111700000000110000000000000000000000000000000000000000000000000000000000000000000000000000000000000
1111111111111111111111333244444440000000000000000000000000000000000000000000000000000000000000000000070000000000000000
1111111111111111111111000000000000000000000000000000000000000000000000000000000000000000011111111111111111111111111111
1111111111111111111111000000000000000000000000001111110000011111000011111000000111111000000000000000000000000000000001
1111111111111111111111000000000000000011111100001111110000000000000000000000000111111000000000000000000000000000000001
1111111111111111111111000000000000000000000000001111110000000000000000000000000111111000000000000009000000000000000001
1111111111111111111111000000000000000000000000001111110900009000090000900000000111111111111111111111111111111111111111
1111111111111111111111333332444443333333333333331111111111111111111111111111111111111111111111111111111111111111111111